1111111
10P1E01
1C101C1
1001001
110C011
1111111